1111111111
1000000001
100MMMMM01
100MAAA001
100MA9A001
100MAAAM01
100MMMMM01
1000000001
1000000001
1111111111


